111111111111111
100110000001001
110110110100011
110010011101111
111011010100001
110111010111101
000001000100001
101101011111111
101100000100011
101101010001000
111111111111111