1111111111
1001100001
1101101100
1100000111
1110110101
1101110101
0000010001
1011010111
1011000001
1111111111
